FAILED SEARCH: 'surgery' (Normalized: 'surgery')
Significant Search Words: {'surgery'}
Sample Symptom Map Keys (First 50):
 - loss of head control (Normalized: loss of head control)
 - headache (Normalized: headache)
 - delirium (Normalized: delirium)
 - loss of libido (Normalized: loss of libido)
 - tinnitus (Normalized: tinnitus)
 - ear pain (Normalized: ear pain)
 - abdomen distension (Normalized: abdomen distension)
 - urinary retention (Normalized: urinary retention)
 - lacrimation (Normalized: lacrimation)
 - rhinorrhea (Normalized: rhinorrhea)
 - tremors (Normalized: tremors)
 - bromhidrosis (Normalized: bromhidrosis)
 - general debility (Normalized: general debility)
 - wheezing (Normalized: wheezing)
 - dyspnoea (Normalized: dyspnoea)
 - tongue retraction (Normalized: tongue retraction)
 - sexual frigidity (Normalized: sexual frigidity)
 - convulsion (Normalized: convulsion)
 - trismus (Normalized: trismus)
 - ejaculation of sperm (Normalized: ejaculation of sperm)
 - giddiness (Normalized: giddiness)
 - red eye (Normalized: red eye)
 - epiphora (Normalized: epiphora)
 - amnesia (Normalized: amnesia)
 - unconsciousness (Normalized: unconsciousness)
 - torticollis (Normalized: torticollis)
 - blepharospasm (Normalized: blepharospasm)
 - ptyalism (Normalized: ptyalism)
 - myokymia (Normalized: myokymia)
 - lip fasciculation (Normalized: lip fasciculation)
 - emesis (Normalized: emesis)
 - cephalalgia (Normalized: cephalalgia)
 - rapid pulsation (Normalized: rapid pulsation)
 - mydriasis (Normalized: mydriasis)
 - ophthalmalgia (Normalized: ophthalmalgia)
 - otalgia (Normalized: otalgia)
 - kyphosis (Normalized: kyphosis)
 - hiccups (Normalized: hiccups)
 - unexpected stabbing pain which disappear rapidly (Normalized: unexpected stabbing pain which disappear rapidly)
 - neck pain (Normalized: neck pain)
 - limb weakness (Normalized: limb weakness)
 - tongue protrusion (Normalized: tongue protrusion)
 - tachypnea (Normalized: tachypnea)
 - visual impairment (Normalized: visual impairment)
 - paraesthesia (Normalized: paraesthesia)
 - prostration (Normalized: prostration)
 - vomiting (Normalized: vomiting)
 - diminished vision (Normalized: diminished vision)
 - deafness (Normalized: deafness)
 - hyperhidrosis (Normalized: hyperhidrosis)
